#####
# r #
# @ #
#   #
#   #
#####